GGGGGAAAA
GAAAGAAAA
GAPAGGGGG
GAAAAAAEG
GGGGGGGGG