GGGGGGGGGGGGG
GAAAAAAAAAAAG
GAAAAAAAAAAAG
GAAAAGAAAAAAG
GPAAAGAAAAAEG
GGGGGGGGAAGGG